# Resources from graph.properties
alreadyConnected=节点已连接
cancel=取消
close=关闭
collapse-expand=收缩/展开
containsValidationErrors=包含验证错误
done=完成
doubleClickOrientation=双击以更改方向
error=错误
errorSavingFile=保存文件时出错
ok=OK
updatingDocument=更新文件。 请耐心等待...
updatingSelection=更新选择。 请耐心等待...
# Custom resources
about=关于我们
actualSize=真实大小
add=添加
addLayer=添加图层
addProperty=添加属性
addToExistingDrawing=添加到现有图形
addWaypoint=设置为流向线
advanced=高级
align=对齐
alignment=对准
allChangesLost=所有更改都将丢失！
angle=角度
apply=应用
arrange=布局
arrow=箭头
arrows=箭头组
automatic=自动
autosave=自动保存
autosize=自动尺寸
background=背景
backgroundColor=背景颜色
backgroundImage=背景图片
basic=基本
block=分块
blockquote=大段引用
bold=加粗
borderWidth=边框宽度
borderColor=边框颜色
bottom=底部
bottomAlign=底部对齐
bottomLeft=左下方
bottomRight=右下角
bulletedList=项目符号列表
cannotOpenFile=不能打开文件
center=中央
change=更改
changeOrientation=改变方向
circle=圈
classic=经典
clearDefaultStyle=清除默认样式
clearWaypoints=明确的方式点
clipart=剪贴画
collapse=收缩
collapseExpand=收缩/展开
collapsible=可折叠
comic=滑稽
connect=连
connection=连接
connectionPoints=连接点
connectionArrows=连线
constrainProportions=约束比例
copy=拷贝
copyConnect=拷贝连接
create=创建
curved=弯曲
custom=自定义
cut=剪切
dashed=虚线
decreaseIndent=减少缩进
default=默认
delete=删除
deleteColumn=删除列
deleteRow=删除行
diagram=基本属性配置
diamond=菱形
diamondThin=菱形 （薄）
direction=方向
distribute=发散
divider=分频器
documentProperties=文档属性
dotted=带点
drawing=画画{1}
drawingEmpty=绘图是空的
drawingTooLarge=绘图太大了
duplicate=复制并生成
duplicateIt=复制{1}个并生成 
east=东
edit=编辑
editData=配置流程节点
editDiagram=编辑图
editImage=编辑图像
editLink=编辑链接
editStyle=编辑样式
editTooltip=编辑工具提示
enterGroup=输入组
enterValue=输入值
enterName=输入名字
enterPropertyName=输入属性名
entityRelation=实体关系
exitGroup=退出组
expand=扩展
export=导出
extras=附加功能
file=文件
fileNotFound=文件不存在
filename=文件名
fill=填充
fillColor=填充颜色
fitPage=整页
fitPageWidth=页面宽度
fitTwoPages=两页
fitWindow=适合的窗口
flip=翻动
flipH=翻转水平
flipV=翻转垂直
font=字体
fontFamily=字体系列
fontColor=字体颜色
fontSize=字体大小
format=格式化
formatPanel=格式面板
formatPdf=PDF
formatPng=PNG
formatGif=GIF
formatJpg=JPEG
formatSvg=SVG
formatXml=XML
formatted=格式化
formattedText=格式化文本
general=普通
glass=玻璃
global=全局
gradient=梯度
gradientColor=颜色
grid=栅格
gridSize=网格大小
group=组
guides=向导
heading=标题
height=高度
help=帮助
hide=隐藏
hideIt=隐藏 {1}
hidden=隐藏
home=Home
horizontal=横
horizontalFlow=水平流动
horizontalTree=水平树
html=HTML
image=设置背景图片
images=Images
import=导入流程
increaseIndent=增加缩进
insert=插入
insertColumnBefore=向左插入列
insertColumnAfter=向右插入列
insertHorizontalRule=插入水平规则
insertImage=插入图片
insertLink=插入链接
insertRowBefore=在上面插入行
insertRowAfter=在下面插入行
invalidName=名称无效
invalidOrMissingFile=文件无效或丢失
isometric=等距
italic=斜体
layers=图层
landscape=景观
laneColor=车道颜色
layout=布局
left=左
leftAlign=左对齐
leftToRight=左到右
line=连线
link=链接
lineend=线路结束
lineheight=线高
linestart=开始箭头
linewidth=线宽度
loading=加载
lockUnlock=锁定/解锁
manual=手册
middle=中间
misc=杂项
more=更多
moreResults=更多结果
move=移动
moveSelectionTo=将选择移动到 {1}
navigation=导航
new=新建
noColor=没有颜色
noFiles=没有文件
noMoreResults=没有更多的结果
none=None
noResultsFor=没有结果 '{1}'
normal=正常
north=北
numberedList=编号清单
opacity=不透明度
open=打开
openArrow=打开箭头
openFile=打开文件
openLink=打开链接
openSupported=支持的格式是从该软件保存的.XML文件
openInNewWindow=在新窗口中打开
openInThisWindow=在此窗口中打开
options=选项
organic=有机
orthogonal=正交
outline=轮廓
oval=椭圆
pages=页面
pageView=预览
pageScale=页面比例
pageSetup=页面设置
panTooltip=空格+拖动滚动
paperSize=纸张尺寸
paste=粘贴
pasteHere=粘贴到此处
pattern=图案
perimeter=周长
placeholders=占位符
plusTooltip=单击以连接并克隆（按住Ctrl键并单击以克隆，按住Shift键并单击以进行连接）。 拖动以连接（按住Ctrl键并拖动到克隆）。
portrait=画像
position=位置
posterPrint=海报打印
preview=预览
print=打印
radialTree=径向树
redo=撤销
removeFormat=清空格式
removeFromGroup=从组中删除
removeIt=Remove {1}
removeWaypoint=删除路点自定义
rename=Rename
renameIt=Rename {1}
replace=Replace
replaceIt={1} 已经存在。 你想替换它吗？
replaceExistingDrawing=替换现有图纸
reset=重置
resetView=重置视图
reverse=倒转
right=向右
rightAlign=对齐
rightToLeft=右到左
rotate=旋转
rotateTooltip=单击并拖动以旋转，单击以旋转90度
rotation=回转
rounded=圆角
save=保存
saveAs=另存为
saved=已保存
scrollbars=滚动条
search=查找
searchShapes=请输入
selectAll=全选
selectEdges=选择边缘
selectFont=选择一个字体
selectNone=选择无
selectVertices=选择顶点
setAsDefaultStyle=设为默认样式
shadow=阴影
shape=形状
sharp=尖锐
sidebarTooltip=点击展开。 将形状拖放到图表中。 按住Shift键并单击以更改选择。 按住Alt并单击以插入并连接。
simple=简单
simpleArrow=简单箭头
size=尺寸
solid=固体
sourceSpacing=源间距
south=南
spacing=间距
straight=直行
strokeColor=线条颜色
style=样式
subscript=标
superscript=标
table=表格
targetSpacing=目标间距
text=文本
textAlignment=文字对齐
textOpacity=文字不透明度
toBack=显示至最底层
toFront=显示至最外层
tooltips=提示
top=顶部
topAlign=顶部对齐
topLeft=左上方
topRight=右上
transparent=透明
turn=旋转90°
uml=UML
underline=下划线
undo=重做
ungroup=取消组合
url=URL
untitledLayer=无标题图层
vertical=垂直
verticalFlow=垂直流动
verticalTree=垂直树
view=视图
waypoints=航点
west=西
width=宽度
wordWrap=自动换行
writingDirection=写作方向
zoom=放大/缩小
zoomIn=放大
zoomOut=缩小
